########____########
#G#__#________#__#G#
#____#_#____#_#____#
#_##_#_#____#_#_##_#
#_##_#_#____#_#_##_#
#______##__##______#
###_####____####_###
____________________
###_####____####_###
#______##__##______#
#______##P_##______#
###_####____####_###
____________________
###_####____####_###
#______##__##______#
#_##_#_#____#_#_##_#
#_##_#_#____#_#_##_#
#____#_#____#_#____#
#G#__#________#__#G#
########____########