########____########
#G##_#________#_##G#
#____#_#____#_#____#
#_##_#_#____#_#_##_#
#_##_#_#____#_#_##_#
#______##__##______#
###_####____####_###
_________##_________
###_####____####_###
#______##__##______#
#______##P_##______#
###_####____####_###
_________##_________
###_####____####_###
#______##__##______#
#_##_#_#____#_#_##_#
#_##_#_#____#_#_##_#
#____#_#____#_#____#
#G##_#________#_##G#
########____########